r√∂ntgenaugu	NP
IP-MAT	IP
IP-MAT-SPE-PRN	IP
IP-MAT-SPE	IP
IP-MAT-PRN	IP
IP-SUB	IP
IP-SUB-SPE	IP
IP-ABS	IP
IP-ABS-SPE	IP
NP-ADT	NP
NP-ADV	NP
NP-COM	NP
NP-LFD	NP
NP-TMP	NP
NP-POS	NP
NP-PRN	NP
PP-BY	PP
PP-LFD	PP
ADJP-SPR	ADJP
ADVP-LOC	ADVP
ADVP-TMP	ADVP
ADVP-DIR	ADVP
ADVP-RSP	ADVP
CP-THT-PRN	CP
CP-THT	CP
CP-ADV	CP
CP-ADV-SPE	CP
CP-THT-SPE	CP
CP-REL	CP
CP-FRL	CP
CP-REL-SPE	CP
CP-FRL-SPE	CP
IP-INF-SBJ	IP
IP-INF	IP
IP-INF-SPE	IP
IP-INF-SBJ-SPE	IP
ADJP*PRN	ADJP
ADJX	ADJX
ADVP*PRN	ADVP
ADVP*PRN*REP	ADVP
ADVX	ADVX
BP	NP
CONJP	CONJP
CONPJ	CONJP
CP	CP
CP-ADV-LFD	CP
CP-ADV	CP
CP-AUE	CP
CP-CAR	CP
CP-CLF	CP
CP-CMP	CP
CP-COM	CP
CP-DEG	CP
CP-EOP	CP
CP-EXL	CP
CP-QUE	CP
CP-QUE-ADV	CP
CP-QUE-PRN	CP
CP-QUE-SBJ	CP
CP-QUE-SPE-SBJ	CP
CP-THT-SPE-SBJ	CP
CP-THT-SBJ	CP
CP-REL-MISS	CP
CP-THT-SPE1	CP
CP-TMC	CP
DP	NP
ENGLISH	FOREIGN
FRAG	FRAG
FS	FS
INTJP	INTJP
IP	IP
IP-ABS-SBJ	IP
IP-IMP	IP
IP-IMP-SPE-SBJ	IP
IP-INF-ABS	IP
IP-INF-ADT	IP
IP-INF-DEG	IP
IP-INF-PRD	IP
IP-INF-PRN	IP
IP-INF-PRP-PRN	IP
IP-INF-SPE-ADT	IP
IP-INF-SPE-DEG	IP
IP-INF-SPE-PRN	IP
IP-INF-SPE-SBJ	IP
IP-INF-	IP
IP-ING	IP
IP-MAT-OB1	IP
IP-MAT-SBJ	IP
IP-MAT-SPE-SBJ	IP
IP-PPL	IP
IP-PPL-ABS	IP
IP-PPL-OB1	IP
IP-PPL-OB2	IP
IP-PPL-PRD	IP
IP-PPL-SBJ	IP
IP-PPL-SPE-OB1	IP
IP-SMC	IP
IP-SMC-SBJ	IP
IP-SUB-MISS	IP
IP-SUB-PRN	IP
IP-SUB-REP	IP
IP-SUB-SPE-PRN	IP
IP-SUB-SUB	IP
IP-SUV	IP
LATIN	FOREIGN
META	META
MP	NP
N-POS	NP
NB-SBJ	NP-SBJ
NEGP	ADVP
NP-CMP	NP
NP-DIR	NP
NP-DIRJ	NP
NP-OB3	NP
NP-PB1	NP
NP-PRN-LLL	NP
NP-PRN-REP	NP
NP-PRO	NP
NP-SBP	NP-SBJ
NP-SMR	NP
NP-SPE-SBJ	NP-SBJ
NP-SPJ	NP-SBJ
NP-SPR	NP
NP-VOC	NP
NPX	NP
NP	NP
NS
NUMP	NUMP
NX	NX
PP-PRN	PP
PP-BY	PP
PP-RSP-BY	PP
PX	PP
QP	QP
QTP	QTP
QTP-SBJ	QTP
QX	QP
REF	REF
RRC	RRC
UNKNOWN	CONJP
VP	VP
WADJP	WADJP
WADJX	WADJP
WNP-PRN	WNP
WNX	WNP
WPP	WPP
WQP	WQP
WXP	CP
X
XP
